1111111111111111111111111111111111
1EF0000000000F0C00000C0000F0000001
101001010F100000101001000000010101
1010010010101010001001000F0001F101
1P0000F000C00C00000000000000FC00C1
1111111111111111111111111111111111