1111111111111
1E00000000001
101C010010101
101C010010101
1P00000X00001
1111111111111