1111111111111
1E00000000001
101C010010101
101C01001011
1P00000000001
1111111111111