1111111111111
1E0000F000001
101C010010101
101C010010101
1P00000000001
1111111111111